MMMMMMMMMMMMMMMMMMMM
M                  M
M                  M
M      H           M
M                  M
M P  G     T   P   M
M    GB            M
M                  M
M                  M
MMMMMMMMMMMMMMMMMMMM