MMMMMMMMMMMMMMMMMMMM
M                  M
M                  M
M                  M
M                  M
M       B      T   M
M                  M
M                  M
M                  M
MMMMMMMMMMMMMMMMMMMM