MMMMMMMMMMMMMMMMMMMM
M       M          M
M   P T M    P     M
M P     M          M
MMMMMMMMMMMM M MMMMM
M       M          M
M       M          M
M     PBG          M
M       M          M
MMMMMMMMMMMMMMMMMMMM